1 1 1 1 1 1 1 1 1 1 1 1 1 1 1 1 1 1 1 1 1 1 1 1 1 69 69 69 69 1 1 1 1 1 1 1 1 1 1 1 1 1 1 1 1 69 69 69 69 1 1 1 1 1 1 1 1 1 1 1 1 6 68 5
6 21 21 21 21 21 21 21 21 21 21 21 21 24 23 21 21 21 24 1 1 1 1 23 22 16 17 18 15 20 65 1 1 1 1 66 21 21 65 1 1 1 1 66 22 67 67 67 67 20 65 1 1 1 1 1 23 21 21 21 21 22 68 5
6 52 53 53 52 53 53 52 53 53 52 53 53 20 22 14 11 12 5 1 1 1 1 6 11 12 13 14 52 54 55 56 21 21 58 59 48 48 55 56 21 21 58 59 48 48 48 48 48 48 55 60 61 1 1 1 6 14 11 62 62 63 64 5
6 45 45 45 45 45 45 45 45 45 45 45 45 45 15 16 17 18 20 21 21 21 21 22 17 18 9 16 45 45 46 53 48 48 48 48 53 52 48 48 48 48 53 53 54 53 52 48 48 48 48 48 55 56 21 24 6 16 17 57 2 2 2 1
6 39 40 36 39 40 36 39 40 36 39 40 36 35 11 12 13 14 11 12 37 36 11 12 13 14 19 12 44 45 45 45 46 47 48 49 45 45 46 47 48 49 50 51 45 45 45 46 52 53 48 48 48 48 53 5 6 12 13 20 21 21 21 24
6 4 4 4 28 29 4 4 4 4 4 4 4 4 17 18 15 16 17 18 33 4 17 18 15 16 17 18 27 34 41 42 37 35 38 36 37 35 37 35 43 44 45 45 45 45 45 45 45 45 46 47 48 49 50 20 22 18 15 16 17 18 15 5
6 4 4 4 4 4 4 4 4 4 4 4 4 4 13 14 19 12 13 19 4 4 19 14 11 19 13 14 4 4 4 4 4 4 4 4 4 27 30 31 32 33 34 35 36 37 35 37 35 37 35 37 38 37 39 40 37 14 11 12 13 14 11 5
6 4 4 4 4 4 4 4 4 4 4 4 4 4 15 16 17 18 15 16 4 4 15 16 17 18 15 16 4 4 4 4 4 4 4 4 4 4 4 4 4 4 4 4 4 27 28 29 4 4 4 4 4 4 4 4 4 16 17 18 15 16 17 5
6 4 4 4 4 4 4 4 4 4 4 4 4 4 11 12 13 14 11 12 4 4 11 12 13 14 11 12 4 4 4 4 4 4 4 4 4 4 4 4 4 4 4 4 4 4 4 4 4 4 4 4 4 4 4 4 4 4 4 4 4 4 25 1
6 4 4 4 4 4 4 4 4 4 4 4 4 4 17 18 15 16 17 18 4 4 17 18 15 16 17 18 4 4 4 4 4 4 4 4 4 4 4 4 4 4 4 4 4 4 4 4 4 4 4 4 4 4 4 4 4 4 4 4 4 4 4 5
6 4 4 4 4 4 4 4 4 4 4 4 4 4 4 4 4 4 4 4 4 4 4 4 4 4 4 4 4 4 4 4 4 4 4 4 4 4 4 4 4 4 4 4 4 4 4 4 4 4 4 4 4 4 4 4 4 4 4 4 4 4 4 5
6 4 4 4 4 4 4 4 4 4 4 4 4 4 4 4 4 4 4 4 4 4 4 4 4 4 4 4 4 4 4 4 4 4 4 4 4 4 4 4 4 4 4 4 4 4 4 4 4 4 4 4 4 4 4 4 4 4 4 4 4 4 4 5
6 4 4 4 4 4 4 4 4 4 4 4 4 4 4 4 4 4 4 4 4 4 4 4 4 4 4 4 4 4 4 4 4 4 4 4 4 4 4 4 4 4 4 4 4 4 4 4 4 4 4 4 4 4 4 4 4 4 4 25 26 4 4 5
1 2 2 2 2 2 2 2 2 2 3 4 4 4 4 4 4 4 4 4 4 4 4 4 4 4 4 4 4 4 4 4 4 4 4 4 4 4 4 4 4 4 4 4 4 4 4 4 4 4 4 4 4 4 4 4 4 4 4 4 4 4 4 5
23 21 21 24 1 1 23 21 21 21 22 4 4 4 4 4 4 4 4 4 4 4 4 4 4 4 4 4 4 4 4 4 4 4 4 4 4 4 19 4 4 4 4 25 26 4 4 4 19 4 4 4 19 4 4 4 19 4 4 4 4 4 4 5
6 13 14 5 1 1 6 11 12 4 4 4 4 4 4 4 4 4 4 4 4 4 4 4 4 4 4 4 4 4 4 4 4 4 4 4 4 4 4 4 4 4 4 4 4 4 4 4 4 4 4 4 4 4 4 4 4 4 4 4 4 4 4 5
6 15 16 20 21 21 22 17 18 4 4 4 4 4 4 4 4 4 4 4 4 4 4 4 4 4 4 4 4 4 4 4 4 4 4 4 4 4 4 4 4 4 4 4 4 4 4 4 4 4 4 4 4 4 4 4 4 4 4 4 4 4 4 5
6 11 12 13 14 11 12 13 14 4 4 4 4 4 4 4 4 4 4 4 4 4 4 4 4 4 4 4 4 4 4 4 4 4 4 19 4 4 4 4 4 4 4 4 4 4 4 4 4 4 4 4 4 4 4 4 4 4 4 4 4 4 4 5
6 17 18 9 10 17 18 15 16 4 4 4 4 4 4 4 4 4 4 4 4 4 4 4 4 4 4 4 4 4 4 4 4 4 4 4 4 4 4 4 4 4 4 4 4 4 4 4 4 4 4 4 4 4 4 4 4 4 4 4 4 4 4 5
6 13 14 11 12 13 14 11 12 4 4 4 4 4 4 4 4 4 4 4 4 4 4 4 4 4 4 4 4 4 4 4 4 4 4 4 4 4 4 4 4 4 4 4 4 4 4 4 4 4 4 4 4 4 4 4 4 4 4 4 4 4 4 5
6 15 16 17 18 9 10 17 18 4 4 4 4 4 4 4 4 4 4 4 4 4 4 4 4 4 4 4 4 4 4 4 4 4 4 4 4 4 4 4 4 4 4 4 4 4 4 4 4 4 4 4 4 4 4 4 4 4 4 4 4 4 4 5
6 11 12 13 14 11 12 13 14 4 4 4 4 4 4 4 4 4 4 4 4 4 4 4 4 4 4 4 4 4 4 4 4 4 4 4 4 4 4 4 4 4 4 4 4 4 4 4 4 4 4 4 4 4 4 4 4 4 4 4 4 4 4 5
6 7 8 9 10 7 8 9 10 4 4 4 4 4 4 4 4 4 4 4 4 4 4 4 4 4 4 4 4 4 4 4 4 4 4 4 4 4 4 4 4 4 4 4 4 4 4 4 4 4 4 4 4 4 4 4 4 4 4 4 4 4 4 5
1 2 2 2 2 2 2 2 2 2 3 4 4 4 4 4 4 4 4 4 4 4 4 4 4 4 4 4 4 4 4 4 4 4 4 4 4 4 4 4 4 4 4 4 4 4 4 4 4 4 4 4 4 4 4 4 4 4 4 4 4 4 4 5