1  1  1  1  1  1  1  1  1  1  1  1  1  1  1  1  1  1  1  1  1  1  1  1  1  1  1  1  1  1  1  1  1  1  1  1  1  1  1  1  2  3  3  3  4  3  5  6
1  1  1  1  1  1  1  1  1  1  1  1  1  1  1  1  1  1  1  1  1  1  1  1  1  1  1  1  1  1  1  1  1  1  1  1  1  1  1  1  7  8  1  9  10  1  11  6
1  1  1  1  1  1  1  1  1  1  1  1  1  1  1  1  1  1  1  1  1  1  1  1  1  1  1  1  1  1  1  1  1  1  1  1  1  1  1  1  12  13  14  15  16  17  18 19
1  1  1  1  1  1  1  1  1  1  1  1  1  1  1  1  1  1  1  1  1  1  1  1  1  1  1  1  1  1  1  1  1  1  1  1  1  1  1  1  20  21  22  23  24  25  3  26
1  1  1  1  1  1  1  1  1  1  1  1  1  1  1  1  1  1  1  1  1  1  1  1  1  1  1  1  1  1  1  1  1  1  1  1  1  1  1  1  27  28  29  30  30  31  1  32
1  1  1  1  1  1  1  1  1  1  1  1  1  1  1  1  1  1  1  1  1  1  1  1  1  1  1  1  1  1  1  1  1  1  1  1  1  1  1  1  33  34  35  36  30  37  38  39
40  41  41  42  40  41  41  41  43  41  41  41  41  41  44  6  1  1  1  1  1  1  1  1  1  1  1  1  1  1  1  1  1  1  1  1  1  1  1  1  45  46  47  30  30  31  48  49
50  23  51  52  28  23  23  53  54  55  56  57  58  59  60  32  1  1  1  1  1  1  1  1  1  1  1  1  1  1  1  1  1  1  1  1  1  1  1  1  7  8  61  62  63  64  1  65
50  36  66  67  68  69  70  71  72  73  74  75  76  77  18  19  1  1  1  1  1  1  1  1  1  1  1  1  1  1  1  1  1  1  1  1  1  1  1  1  78  79  80  1  1  1  81  82
50  83  84  85  86  64  73  87  88  89  90  91  92  93  94  94  1  1  1  1  1  1  1  1  1  1  1  1  1  1  1  1  1  1  1  1  1  1  1  1  7  1  95  96  1  97  98  94
50  99  94  100  101  85  1  102  97  103  104  105  106  94  94  94  1  1  1  1  1  1  1  1  1  1  1  1  1  1  1  1  1  1  1  1  1  1  1  1  7  75  107  1  1  108  109  110
50  6  94  94  94  111  112  105  113  50  114  65  94  94  94  94  1  1  1  1  1  1  1  1  1  1  1  1  1  1  1  1  1  1  1  1  1  1  1  1  115  114  116  117  118  119  120  6
50  6  27  41  43  41  41  41  41  41  41  41  41  41  41  41  41  49  27  41  41  41  49  94  121  122  122  122  122  122  122  122  122  122  122  122  122  122  122  123  94  124  125  125  125  125  5  6  
50  126  127  57  54  55  56  128  57  129  23  23  23  130  129  23  23  46  131  68  53  23  65  94  121  122  122  122  122  122  122  122  122  122  122  122  122  122  122  123  94  132  133  133  133  133  54  6
134  135  136  137  60  73  74  138  139  140  63  70  30  31  140  63  141  128  59  86  142  63  46  143  144  145  145  146  145  147  145  145  146  145  147  145  145  146  145  148  149  150  151  151  152  153  54  6
154  155  1  156  157  158  1  159  97  119  160  161  63  64  138  139  162  102  1  163  138  164  1  165  166  167  168  169  170  171  167  168  169  170  171  167  168  169  170  172  173  1  1  1  174  163  54  6
94  175  176  1  177  1  97  119  113  94  94  178  179  180  102  181  182  183  184  185  186  187  188  189  190  191  191  192  191  193  191  191  192  191  193  191  191  192  191  194  195  196  1  1  1  1  197  198
94  94  199  114  200  118  113  94  94  94  94  94  94  178  119  120  201  202  203  118  119  204  94  94  121  122  122  122  122  122  122  122  122  122  122  122  122  122  122  123  94  205  114  114  114  118  119  206 
