3 50 51 9 1 1 3 50 51 39 40 40 40 40 40 40 40 41 51 50 30 31 51 50 20 21 51 50 51 50 51 50 51 50 51 50 51 50 51 50 39 40 40 40 40 40 40 40 40 40 40 40 40 40 40 40 40 40 40 40 40 41 49 9
3 4 5 9 1 1 3 4 5 32 33 33 33 33 33 33 33 34 5 4 26 27 5 4 13 14 5 4 47 4 5 48 5 4 47 4 5 48 5 4 32 33 33 33 33 33 33 33 33 33 33 33 33 33 33 33 33 33 33 33 33 34 49 9
3 10 11 39 40 40 41 10 11 10 11 10 11 10 11 10 11 10 11 10 42 43 11 10 42 43 11 10 44 10 11 44 11 10 44 10 11 44 11 10 11 10 6 7 8 24 25 25 6 7 8 24 25 25 6 7 8 24 25 16 16 45 46 9
3 4 5 32 33 33 34 4 5 4 5 4 5 4 5 4 5 4 5 4 5 4 5 4 5 4 5 4 35 4 5 36 5 4 35 4 5 36 5 4 5 4 6 7 8 24 25 25 6 7 8 24 25 25 6 7 8 24 25 37 38 38 38 1
3 10 11 10 11 10 11 10 11 10 11 10 11 10 11 28 29 10 11 10 11 10 11 10 11 10 11 10 11 10 11 10 11 10 11 10 11 10 11 10 11 10 6 7 8 18 19 19 6 7 8 24 25 25 6 7 8 18 19 19 19 30 31 9
3 4 5 4 5 4 5 4 5 4 5 4 5 4 5 9 3 4 5 4 5 4 5 4 5 4 5 4 5 4 5 4 5 4 5 4 5 4 5 4 5 4 22 16 23 4 5 4 6 7 8 24 25 25 6 7 8 4 5 4 5 26 27 9
3 10 11 10 11 10 11 10 11 10 11 10 11 10 11 9 3 10 11 10 11 10 11 10 11 10 11 10 11 10 11 10 11 10 11 10 11 10 11 10 11 10 6 7 8 10 11 10 15 16 17 18 19 19 15 16 17 10 11 10 11 20 21 9
3 4 5 4 5 4 5 4 5 4 5 4 5 4 5 9 3 4 5 4 5 4 5 4 5 4 5 4 5 4 5 4 5 4 5 4 5 4 5 4 5 4 5 4 5 4 5 4 6 12 8 4 5 4 6 12 8 4 5 4 5 13 14 9
3 10 11 10 11 10 11 10 11 10 11 10 11 10 11 9 3 10 11 10 11 10 11 10 11 10 11 10 11 10 11 10 11 10 11 10 11 10 11 10 11 10 11 10 11 10 11 10 6 7 8 10 11 10 6 7 8 10 11 10 11 10 10 9
3 4 5 4 5 4 5 4 5 4 5 4 5 4 5 9 3 4 5 4 5 4 5 4 5 4 5 4 5 4 5 4 5 4 5 4 5 4 5 4 5 4 5 4 5 4 5 4 6 7 8 4 5 4 6 7 8 4 5 4 5 4 5 9
3 10 11 10 11 10 11 10 11 10 11 10 11 10 11 9 3 10 11 10 11 10 11 10 11 10 11 10 11 10 11 10 11 10 11 10 11 10 11 10 11 10 11 10 11 10 11 10 6 7 8 10 11 10 6 7 8 10 11 10 11 10 11 9
1 2 2 2 2 2 2 2 2 2 2 2 2 2 2 1 3 4 5 4 5 4 5 4 5 4 5 4 5 4 5 4 5 4 5 4 5 4 5 4 5 4 5 4 5 4 5 4 6 7 8 4 5 4 6 7 8 4 5 4 5 4 5 9