37 37 37 37 37 38 50 50 150 50 50 55 37 37 37 37 37 37 37 37 37 37 37 37 37 37 37 37 19 19 19 38 50 96 96 96 96 96 50 55 19 19 37 37 37 37 37 37 2 103 103 103 103 103 103 103 103 103 103 103 103 103 103 103 103 103 103 103 103 103 103 103 103 103 103 103 103 103 103 4 37 37 37 38 50 50 50 50 50 50 50 55 19 19 19 37
37 37 37 37 131 34 47 47 150 47 47 81 91 37 37 37 37 37 37 37 37 37 37 37 37 37 37 89 10 11 33 34 47 25 26 26 26 151 47 81 76 11 152 37 37 37 37 37 38 103 103 103 103 103 103 103 103 103 103 103 103 103 103 103 103 103 103 103 103 103 103 103 103 103 103 103 103 103 103 55 37 37 32 153 47 47 47 47 47 47 47 81 10 154 155 28
37 37 37 131 12 1 1 1 49 24 1 1 9 18 19 19 37 37 37 37 37 37 37 37 37 89 90 83 1 6 17 86 1 9 18 19 131 12 1 143 7 6 136 137 144 37 19 145 146 96 96 96 96 96 96 96 96 96 96 96 96 96 96 96 96 96 96 96 96 96 96 96 96 96 96 96 96 96 96 147 148 19 38 8 1 1 1 1 1 1 1 1 1 43 149 4
37 19 131 12 1 1 1 75 132 17 29 1 1 9 133 11 91 37 37 37 37 37 37 89 90 83 1 1 1 6 8 79 80 1 9 11 12 1 134 135 1 6 86 1 136 137 10 138 139 140 141 141 141 141 140 141 141 141 141 140 141 141 141 141 140 141 141 141 141 140 141 141 141 141 140 141 141 141 141 139 142 10 34 1 1 1 1 1 1 1 70 24 13 14 5 4
32 10 12 1 1 1 75 69 120 8 121 122 1 1 16 6 9 18 19 19 37 89 90 83 1 1 1 1 1 3 1 1 123 1 1 6 1 1 16 17 1 3 79 80 1 1 1 124 125 126 127 128 129 127 126 127 128 129 127 126 127 128 129 127 126 127 128 129 127 126 127 128 129 127 126 127 128 129 127 125 130 1 1 1 1 1 1 1 1 1 16 17 4 2 5 4
2 61 61 62 1 70 74 75 69 1 111 112 1 1 7 6 1 9 10 11 82 83 1 65 61 61 62 1 81 11 94 1 1 1 1 6 1 1 7 8 81 11 94 72 1 1 1 113 114 115 116 117 118 116 115 116 117 118 116 115 116 117 118 116 115 116 117 118 116 115 116 117 118 116 115 116 117 118 116 114 119 1 1 1 1 1 1 1 1 84 85 8 4 2 5 4
2 30 107 36 1 16 17 69 1 1 1 65 61 62 1 3 1 1 1 6 1 1 1 67 35 35 40 1 1 6 1 1 1 65 61 6 62 1 1 1 1 6 1 1 13 26 26 14 108 109 110 110 110 110 109 110 110 110 110 109 110 110 110 110 109 110 110 110 110 109 110 110 110 110 109 110 110 110 110 108 13 26 14 1 1 1 1 1 1 72 78 1 4 2 5 4
41 14 1 13 14 7 8 1 13 14 1 67 35 40 81 11 94 1 65 6 61 61 61 64 35 35 40 1 65 6 61 61 61 64 30 3 36 1 65 61 61 6 61 61 4 37 37 41 14 103 103 103 103 103 103 103 103 103 103 103 103 103 103 103 103 103 103 103 103 103 103 103 103 103 103 103 103 103 103 13 27 37 2 104 105 105 105 105 105 105 105 106 4 2 5 4
37 2 21 4 2 61 61 61 4 2 61 64 35 60 61 6 61 61 64 6 35 35 35 35 35 35 60 61 64 6 35 35 35 35 13 26 14 1 67 35 35 6 35 35 4 37 37 37 2 103 103 103 103 103 103 103 103 103 103 103 103 103 103 103 103 103 103 103 103 103 103 103 103 103 103 103 103 103 103 4 37 37 2 61 61 61 61 61 61 61 61 61 4 2 5 4
37 2 5 4 2 30 30 30 4 2 30 30 30 30 30 3 30 30 30 3 30 30 30 30 30 30 30 30 30 3 30 30 30 30 4 37 2 1 59 30 30 3 30 30 4 37 37 37 2 103 103 103 103 103 103 103 103 103 103 103 103 103 103 103 103 103 103 103 103 103 103 103 103 103 103 103 103 103 103 4 37 37 2 35 35 35 35 35 35 35 35 35 4 2 5 4
37 2 5 4 41 26 26 26 27 41 26 26 26 26 26 26 26 26 26 26 26 26 26 26 26 26 26 26 26 26 26 26 26 26 27 37 41 26 26 26 26 26 26 26 27 37 37 37 2 103 103 103 103 103 103 103 103 103 103 103 103 103 103 103 103 103 103 103 103 103 103 103 103 103 103 103 103 103 103 4 37 37 2 30 30 30 30 30 30 30 30 30 4 2 5 4
37 2 5 4 37 37 37 37 37 37 37 37 97 57 58 37 37 37 37 97 57 57 58 37 37 37 37 37 37 37 37 37 51 51 51 51 51 51 51 51 51 51 51 51 51 51 51 51 52 98 98 98 98 98 98 98 98 98 98 98 98 98 98 98 98 98 98 98 98 98 98 98 98 98 98 98 98 98 98 54 97 57 99 100 101 101 101 101 100 102 26 26 27 2 5 4
37 2 5 4 37 37 37 37 37 37 37 19 38 50 55 19 37 37 37 2 50 50 4 37 37 37 37 37 37 37 37 37 1 1 1 1 1 1 1 1 1 1 1 1 1 1 1 1 1 1 1 1 1 1 1 1 1 1 1 1 1 1 1 1 1 1 1 1 1 1 1 1 1 1 1 1 1 1 1 1 2 50 50 50 96 96 96 96 50 55 19 19 19 38 5 4
37 2 5 4 37 37 37 37 37 37 89 10 34 47 81 11 91 37 37 2 47 47 4 37 37 37 37 37 37 37 37 37 1 1 1 1 1 1 1 1 1 1 1 1 1 1 1 1 1 1 1 1 1 1 1 1 1 1 1 1 1 1 1 1 1 1 1 1 1 1 1 1 1 1 1 1 1 1 1 1 2 47 47 93 81 11 10 94 47 81 10 10 10 95 5 4
37 2 53 4 37 37 37 37 89 90 83 1 1 1 1 6 9 18 19 38 24 1 55 19 19 37 37 37 37 37 37 37 1 1 1 1 1 1 1 1 1 1 1 1 1 1 1 1 1 1 1 1 1 1 1 1 1 1 1 1 1 1 1 1 1 1 1 1 1 1 1 1 1 1 1 1 1 1 1 1 2 1 1 72 86 6 1 1 1 1 1 1 1 43 92 4
37 2 1 55 19 37 89 90 83 1 1 1 1 1 1 6 1 9 10 68 17 86 81 10 11 91 37 37 37 37 37 37 1 1 1 1 1 1 1 1 1 1 1 1 1 1 1 1 1 1 1 1 1 1 1 1 1 1 1 1 1 1 1 1 1 1 1 1 1 1 1 1 1 1 1 1 1 1 1 1 2 1 1 1 79 3 24 1 1 1 25 26 26 26 26 27
37 2 1 81 10 82 83 1 1 1 1 1 1 65 61 6 62 1 84 85 8 79 86 1 6 9 18 37 37 37 37 37 1 1 1 1 1 1 1 1 1 1 1 1 1 1 1 1 1 1 1 1 1 1 1 1 1 1 1 1 1 1 1 1 1 1 1 1 1 1 1 1 1 1 1 1 1 1 1 1 2 1 1 1 87 88 17 1 1 1 9 18 37 37 37 37
37 2 61 61 62 1 1 77 65 61 62 1 1 67 35 6 40 1 72 78 1 1 79 80 6 1 9 18 19 19 19 37 1 1 1 1 1 1 1 1 1 1 1 1 1 1 1 1 1 1 1 1 1 1 1 1 1 1 1 1 1 1 1 1 1 1 1 1 1 1 1 1 1 1 1 1 1 1 1 1 2 1 1 75 69 6 8 1 1 1 1 9 18 19 37 37
37 2 35 30 40 70 71 72 67 35 40 1 1 67 35 6 36 1 1 65 61 62 1 72 6 1 1 9 10 10 10 28 1 1 1 1 1 1 1 1 1 1 1 1 1 1 1 1 1 1 1 1 1 1 1 1 1 1 1 1 1 1 1 1 1 1 1 1 1 1 1 1 1 1 1 1 1 1 1 1 41 31 73 74 75 6 1 1 1 1 1 1 9 76 28 37
37 2 35 44 66 16 17 1 59 30 60 61 61 64 35 6 13 14 1 67 35 40 1 1 6 1 1 1 1 1 1 4 1 1 1 1 1 1 1 1 1 1 1 1 1 1 1 1 1 1 1 1 1 1 1 1 1 1 1 1 1 1 1 1 1 1 1 1 1 1 1 1 1 1 1 1 1 1 1 1 32 10 68 17 69 6 1 1 1 1 1 1 1 7 4 37
37 2 35 35 63 7 8 13 26 14 35 35 35 35 35 6 4 2 61 64 35 60 61 61 6 61 62 1 1 1 1 4 1 1 1 1 1 1 1 1 1 1 1 1 1 1 1 1 1 1 1 1 1 1 1 1 1 1 1 1 1 1 1 1 1 1 1 1 1 1 1 1 1 1 1 1 1 1 1 1 2 1 7 8 65 6 62 1 1 1 1 1 1 1 4 37
37 2 30 30 36 1 1 4 37 2 30 30 30 30 30 3 4 2 30 30 30 30 30 30 3 30 36 1 13 14 21 4 1 1 1 1 1 1 1 1 1 1 1 1 1 1 1 1 1 1 1 1 1 1 1 1 1 1 1 1 1 1 1 1 1 1 1 1 1 1 1 1 1 1 1 1 1 1 1 1 2 21 1 1 59 6 60 61 61 61 62 1 1 1 4 37
37 41 26 26 26 26 26 27 37 41 26 26 26 26 26 26 27 41 26 26 26 26 26 26 26 26 26 26 27 2 5 4 1 1 1 1 1 1 1 1 1 1 1 1 1 1 1 1 1 1 1 1 1 1 1 1 1 1 1 1 1 1 1 1 1 1 1 1 1 1 1 1 1 1 1 1 1 1 1 1 2 5 13 26 14 6 35 35 35 35 40 1 1 13 27 37
51 51 51 51 51 51 51 51 51 51 51 51 51 51 51 51 51 51 51 51 51 51 51 51 51 51 51 51 51 52 53 54 1 1 1 1 1 1 1 1 1 1 1 1 1 1 1 1 1 1 1 1 1 1 1 1 1 1 1 1 1 1 1 1 1 1 1 1 1 1 1 1 1 1 1 1 1 1 1 1 2 5 55 19 38 6 35 35 35 35 40 1 1 56 57 58
1 1 1 1 1 1 1 1 1 1 1 1 1 1 1 1 1 1 1 1 1 1 1 1 1 1 1 1 1 1 1 1 1 1 1 1 1 1 1 1 1 1 1 1 1 1 1 1 1 1 1 1 1 1 1 1 1 1 1 1 1 1 1 1 1 1 1 1 1 1 1 1 1 1 1 1 1 1 1 1 2 5 48 10 34 6 35 30 35 35 36 1 1 49 50 4
1 1 1 1 1 1 1 1 1 1 1 1 1 1 1 1 1 1 1 1 1 1 1 1 1 1 1 1 1 1 1 1 1 1 1 1 1 1 1 1 1 1 1 1 1 1 1 1 1 1 1 1 1 1 1 1 1 1 1 1 1 1 1 1 1 1 1 1 1 1 1 1 1 1 1 1 1 1 1 1 2 42 43 1 1 6 35 44 35 35 45 1 1 46 47 4
1 1 1 1 1 1 1 1 1 1 1 1 1 1 1 1 1 1 1 1 1 1 1 1 1 1 1 1 1 1 1 1 1 1 1 1 1 1 1 1 1 1 1 1 1 1 1 1 1 1 1 1 1 1 1 1 1 1 1 1 1 1 1 1 1 1 1 1 1 1 1 1 1 1 1 1 1 1 1 1 41 26 26 14 1 3 35 35 35 35 40 1 1 1 1 4
1 1 1 1 1 1 1 1 1 1 1 1 1 1 1 1 1 1 1 1 1 1 1 1 1 1 1 1 1 1 1 1 1 1 1 1 1 1 1 1 1 1 1 1 1 1 1 1 1 1 1 1 1 1 1 1 1 1 1 1 1 1 1 1 1 1 1 1 1 1 1 1 1 1 1 1 1 1 1 1 37 19 19 38 1 39 35 35 35 35 40 1 1 1 1 4
1 1 1 1 1 1 1 1 1 1 1 1 1 1 1 1 1 1 1 1 1 1 1 1 1 1 1 1 1 1 1 1 1 1 1 1 1 1 1 1 1 1 1 1 1 1 1 1 1 1 1 1 1 1 1 1 1 1 1 1 1 1 1 1 1 1 1 1 1 1 1 1 1 1 1 1 1 1 1 1 32 33 10 34 1 6 35 35 35 30 36 1 1 1 1 4
1 1 1 1 1 1 1 1 1 1 1 1 1 1 1 1 1 1 1 1 1 1 1 1 1 1 1 1 1 1 1 1 1 1 1 1 1 1 1 1 1 1 1 1 1 1 1 1 1 1 1 1 1 1 1 1 1 1 1 1 1 1 1 1 1 1 1 1 1 1 1 1 1 1 1 1 1 1 1 1 2 17 29 1 1 3 30 30 30 13 26 31 31 31 31 27
1 1 1 1 1 1 1 1 1 1 1 1 1 1 1 1 1 1 1 1 1 1 1 1 1 1 1 1 1 1 1 1 1 1 1 1 1 1 1 1 1 1 1 1 1 1 1 1 1 1 1 1 1 1 1 1 1 1 1 1 1 1 1 1 1 1 1 1 1 1 1 1 1 1 1 1 1 1 1 1 2 22 23 24 1 25 26 26 26 27 20 10 10 10 10 28
1 1 1 1 1 1 1 1 1 1 1 1 1 1 1 1 1 1 1 1 1 1 1 1 1 1 1 1 1 1 1 1 1 1 1 1 1 1 1 1 1 1 1 1 1 1 1 1 1 1 1 1 1 1 1 1 1 1 1 1 1 1 1 1 1 1 1 1 1 1 1 1 1 1 1 1 1 1 1 1 2 15 16 17 1 9 18 19 19 20 12 1 1 1 21 4
1 1 1 1 1 1 1 1 1 1 1 1 1 1 1 1 1 1 1 1 1 1 1 1 1 1 1 1 1 1 1 1 1 1 1 1 1 1 1 1 1 1 1 1 1 1 1 1 1 1 1 1 1 1 1 1 1 1 1 1 1 1 1 1 1 1 1 1 1 1 1 1 1 1 1 1 1 1 1 1 2 1 7 8 1 1 9 10 11 12 1 1 13 14 5 4
1 1 1 1 1 1 1 1 1 1 1 1 1 1 1 1 1 1 1 1 1 1 1 1 1 1 1 1 1 1 1 1 1 1 1 1 1 1 1 1 1 1 1 1 1 1 1 1 1 1 1 1 1 1 1 1 1 1 1 1 1 1 1 1 1 1 1 1 1 1 1 1 1 1 1 1 1 1 1 1 2 1 1 1 1 1 1 1 6 1 1 1 4 2 5 4
1 1 1 1 1 1 1 1 1 1 1 1 1 1 1 1 1 1 1 1 1 1 1 1 1 1 1 1 1 1 1 1 1 1 1 1 1 1 1 1 1 1 1 1 1 1 1 1 1 1 1 1 1 1 1 1 1 1 1 1 1 1 1 1 1 1 1 1 1 1 1 1 1 1 1 1 1 1 1 1 2 1 1 1 1 1 1 1 3 1 1 1 4 2 5 4
1 1 1 1 1 1 1 1 1 1 1 1 1 1 1 1 1 1 1 1 1 1 1 1 1 1 1 1 1 1 1 1 1 1 1 1 1 1 1 1 1 1 1 1 1 1 1 1 1 1 1 1 1 1 1 1 1 1 1 1 1 1 1 1 1 1 1 1 1 1 1 1 1 1 1 1 1 1 1 1 37 26 26 26 26 26 26 26 26 26 26 26 37 2 5 4