233 24 64 32 32 15 16
0 1 1 1 1 1 1 1 1 1 1 2 3 3 3 3 4 4 4 4 4 4 4 4 4 4 4 4 4 4 4 4 4 4 4 4 4 4 4 4 4 4 4 4 4 4 4 4 4 4 4 4 4 4 4 4 4 4 4 4 4 4 4 4 
5 3 3 3 3 3 3 3 3 3 3 6 3 3 3 3 4 4 4 4 4 4 4 4 4 4 4 4 4 4 4 4 4 4 4 4 4 4 4 4 4 4 4 4 4 4 4 4 4 4 4 4 4 4 4 4 4 4 4 4 4 4 4 4 
5 7 8 3 3 3 3 3 3 3 3 6 3 3 3 3 4 4 4 4 4 4 4 4 4 4 4 4 4 4 4 4 4 4 4 4 4 4 4 4 4 4 4 4 4 4 4 4 4 4 4 4 4 4 4 4 4 4 4 4 4 4 4 4 
5 3 3 3 7 8 3 3 3 3 3 6 3 3 3 3 4 4 4 4 4 4 4 4 4 4 4 4 4 4 4 4 4 4 4 4 4 4 4 4 4 4 4 4 4 4 4 4 4 4 4 4 4 4 4 4 4 4 4 4 4 4 4 4 
5 3 3 3 3 3 3 7 3 3 3 6 3 3 3 3 4 4 4 4 4 4 4 4 4 4 4 4 4 4 4 4 4 4 4 4 4 4 4 4 4 4 4 4 4 4 4 4 4 4 4 4 4 4 4 4 4 4 4 4 4 4 4 4 
9 10 10 10 10 10 10 10 3 8 10 11 3 3 3 3 4 4 4 4 4 4 4 4 4 4 4 4 4 4 4 4 4 4 4 4 4 4 4 4 4 4 4 4 4 4 4 4 4 4 4 4 4 4 4 4 4 4 4 4 4 4 4 4 
0 1 1 1 1 1 1 2 3 3 3 3 3 3 3 3 3 3 3 3 3 3 3 3 3 3 3 3 3 3 3 3 12 13 3 3 3 3 3 3 3 3 3 14 15 3 3 3 3 3 3 3 3 3 3 3 3 3 3 3 3 3 3 3 
5 3 3 3 3 3 3 6 3 3 3 3 3 3 3 3 3 3 3 3 3 3 3 3 3 16 17 3 3 3 3 3 18 19 3 3 3 3 3 3 3 3 3 20 21 3 3 3 3 3 3 3 3 3 3 3 3 3 3 3 3 3 3 3 
9 10 10 3 3 3 3 3 3 3 3 3 3 3 3 3 3 3 3 3 3 3 3 3 3 22 23 3 3 3 3 3 3 24 3 3 3 3 3 3 3 3 3 3 25 3 3 3 3 3 3 3 3 3 3 3 3 3 3 3 3 3 3 3 
26 27 28 29 3 10 10 10 10 10 29 3 3 3 3 3 3 3 3 3 3 3 3 3 3 3 30 31 3 3 3 3 3 32 3 3 3 3 3 3 3 3 3 3 33 3 3 3 3 3 3 3 34 35 3 3 3 3 3 3 3 3 3 3 
36 5 3 8 10 3 3 6 3 3 3 3 3 3 3 3 3 3 3 3 3 3 3 3 3 3 37 3 3 38 39 39 39 40 41 39 39 39 42 43 39 39 39 44 45 39 39 46 47 48 3 3 49 50 3 3 3 3 3 3 3 3 3 3 
36 5 3 3 3 3 3 6 3 3 3 3 3 3 3 3 3 3 3 3 3 3 3 3 3 51 52 3 3 53 54 55 56 57 58 55 56 59 60 61 62 63 55 64 65 66 55 64 67 3 3 3 3 30 31 3 3 3 3 3 3 3 3 3 
36 5 3 3 3 3 3 6 3 3 3 3 3 3 3 3 3 3 3 3 3 3 3 3 3 3 33 3 3 3 3 3 3 32 68 69 3 3 3 3 3 3 3 3 70 71 3 3 3 3 3 3 3 37 3 3 3 3 3 3 3 3 3 3 
72 5 3 3 3 3 3 6 3 3 3 3 3 3 3 3 3 3 3 3 3 3 3 3 3 3 73 74 3 3 3 3 3 32 75 71 3 3 3 3 3 3 3 3 76 68 69 3 3 3 3 3 77 33 3 3 3 3 3 3 3 3 3 3 
78 79 3 3 3 3 3 80 3 3 3 3 3 3 3 3 3 3 3 3 3 3 3 81 82 83 33 3 3 3 3 3 3 32 84 68 69 3 3 85 85 85 3 3 86 68 71 3 3 3 3 3 49 25 3 3 3 3 3 3 3 3 3 3 
87 87 9 10 10 10 29 3 3 3 3 3 3 3 3 3 3 3 3 3 3 88 89 90 91 92 93 94 3 3 3 3 3 32 95 68 96 97 97 97 97 97 97 98 33 75 68 69 3 3 3 3 99 100 3 3 3 3 3 3 3 3 3 3 
3 3 3 3 3 3 3 3 3 3 3 3 3 3 3 3 3 3 3 3 101 102 103 104 105 106 104 107 108 3 3 3 3 109 110 68 111 112 113 114 115 116 117 118 100 84 68 71 3 3 3 119 120 121 89 122 123 124 125 126 126 126 126 127 
3 3 3 3 3 3 3 3 3 3 3 3 3 3 3 3 3 3 3 3 3 128 129 130 131 131 131 131 132 121 89 122 121 89 122 121 89 122 121 89 122 121 89 122 121 89 122 121 133 77 134 135 103 103 103 103 136 137 3 3 3 3 3 3 
3 3 3 3 3 3 3 3 3 3 3 3 3 3 3 3 3 3 3 3 3 3 3 138 103 103 103 103 103 103 103 103 103 103 103 103 103 103 103 103 103 103 103 103 103 103 103 103 103 105 103 103 103 103 103 139 140 141 3 3 3 3 3 3 
3 3 3 3 3 3 3 3 3 3 3 3 3 3 3 3 3 3 3 3 3 3 3 142 143 144 144 145 146 147 148 149 145 146 147 148 149 145 146 147 148 149 145 146 147 148 149 145 146 147 150 144 144 144 144 151 152 3 3 3 3 3 3 3 
3 3 3 3 3 3 153 154 155 3 3 3 3 3 3 3 3 3 3 3 3 3 3 3 156 157 157 158 159 160 161 162 158 159 160 161 162 158 159 160 161 162 158 159 160 161 162 158 159 160 157 163 157 157 164 165 3 3 3 3 3 3 3 3 
3 3 3 3 3 166 167 3 3 3 3 3 3 168 169 167 3 3 3 3 3 170 171 155 3 3 172 173 173 173 173 173 173 173 173 173 173 173 173 173 173 173 173 173 173 173 173 173 173 173 173 174 173 173 175 3 3 3 3 3 3 170 176 3 
177 178 179 180 181 168 182 168 177 178 179 180 183 184 182 185 177 177 186 187 188 189 177 177 182 190 191 192 192 192 192 192 192 192 192 192 192 192 192 192 192 192 192 192 192 192 192 192 192 192 192 193 194 195 196 197 197 197 198 177 199 200 177 177 
201 202 203 204 205 206 207 206 208 202 203 204 201 206 209 210 211 212 208 213 214 215 216 217 218 219 220 221 222 221 222 221 222 221 222 221 222 221 222 221 222 221 222 221 222 221 222 221 222 221 222 221 223 224 225 226 227 226 228 229 214 230 231 232 
