45 6 16 32 32 6 8
0 1 1 1 1 2 3 4 5 6 0 1 1 1 1 2 
7 8 9 8 8 10 11 4 5 12 13 8 9 8 8 14 
15 16 17 18 19 20 21 22 23 21 24 16 17 18 19 25 
26 27 28 27 29 30 31 32 31 31 33 27 28 34 35 36 
37 38 38 39 40 41 40 17 40 40 41 40 42 43 43 43 
44 35 35 35 35 35 35 35 35 35 35 35 43 43 43 43 
