274 24 64 32 32 16 18
0 0 0 0 1 2 0 1 2 0 0 3 4 4 4 4 4 4 4 4 4 4 4 4 4 4 4 4 4 4 4 4 4 4 4 4 4 4 4 4 4 4 4 4 4 4 4 5 6 0 0 0 0 0 0 0 0 0 0 0 0 0 0 0 
4 4 4 4 7 8 4 7 8 4 4 4 4 4 4 4 4 4 4 4 4 4 4 4 4 4 4 4 4 4 4 4 4 4 4 4 4 4 4 4 4 4 4 4 4 4 4 4 9 10 10 10 10 10 10 10 11 12 12 12 12 12 12 12 
4 4 4 4 7 8 4 7 8 4 4 4 4 4 4 4 4 4 4 4 4 4 4 4 4 4 4 4 4 4 4 4 4 4 4 4 4 4 4 4 4 4 4 4 4 4 4 4 9 10 10 10 10 10 10 10 13 14 15 16 16 16 16 16 
4 4 4 4 7 8 4 7 8 4 4 4 4 4 17 18 18 18 18 18 18 18 18 18 18 18 19 4 4 4 4 4 4 4 4 4 20 21 22 4 4 4 23 24 25 4 4 4 9 10 26 27 10 26 27 10 28 29 30 31 32 16 16 16 
4 4 4 4 7 8 4 7 8 4 4 4 4 33 34 35 36 37 36 37 36 37 36 37 36 37 38 39 4 4 4 4 4 4 4 4 40 41 42 4 4 43 44 45 46 47 4 4 9 10 48 49 10 48 49 10 50 51 52 53 54 16 16 16 
55 55 56 57 58 57 58 57 58 57 58 57 58 59 60 61 62 61 62 61 62 61 62 61 62 61 63 64 65 66 67 68 66 69 66 67 70 71 72 66 73 74 59 75 76 77 78 58 57 58 57 58 57 58 57 58 57 58 57 58 57 58 57 58 
4 4 5 0 1 2 0 1 2 0 3 4 4 4 4 4 4 4 4 4 4 4 4 4 4 4 4 4 4 4 4 79 10 10 10 10 10 10 10 10 10 10 10 10 10 10 10 10 10 10 10 10 10 10 10 10 10 10 10 10 10 10 10 10 
80 81 4 4 7 8 4 7 8 4 4 4 4 4 82 83 4 4 4 4 4 4 4 4 84 85 4 4 4 4 4 79 10 10 10 10 10 10 10 10 10 10 10 10 10 10 10 10 10 10 10 10 10 10 10 10 10 10 10 10 10 10 10 10 
86 87 83 4 7 8 4 7 8 4 4 4 4 4 88 89 4 4 4 90 85 4 4 4 91 92 4 4 4 4 4 79 10 10 10 10 10 10 10 10 10 10 10 10 10 10 10 10 10 10 10 10 10 10 10 10 10 10 10 10 10 10 10 10 
93 94 95 4 7 8 4 7 8 4 4 4 4 4 91 92 4 4 4 91 96 4 4 4 97 98 4 4 4 4 4 79 10 10 10 10 10 10 10 10 10 10 10 10 10 10 10 10 10 10 10 10 10 10 10 10 10 10 10 10 10 10 10 10 
99 100 101 102 103 104 105 103 106 107 4 4 4 108 109 110 111 102 102 109 101 102 112 113 114 115 111 102 107 4 4 79 10 10 10 10 10 10 10 10 10 10 10 10 10 10 10 10 10 10 10 10 10 10 10 10 10 10 10 10 10 10 10 10 
116 116 116 116 116 116 116 116 116 117 118 66 119 120 116 116 116 116 116 116 116 116 116 116 116 116 116 116 117 118 4 121 10 10 10 10 10 10 10 10 10 10 10 10 10 10 10 10 10 10 10 10 10 10 10 10 10 10 10 10 10 10 10 10 
10 10 10 10 10 10 10 10 10 10 10 10 10 10 10 10 10 10 10 10 10 10 10 10 122 123 123 123 123 124 125 126 127 128 129 128 129 128 129 130 127 128 129 128 129 128 129 130 127 128 129 128 129 128 129 130 131 123 123 123 132 123 123 133 
10 10 10 10 10 10 10 10 10 10 10 10 10 10 10 10 10 10 10 10 10 10 10 10 134 125 125 125 125 125 135 10 136 137 138 137 138 137 138 137 138 137 138 137 138 137 138 137 138 137 138 137 138 137 138 139 10 125 125 125 125 125 125 140 
10 10 10 10 10 10 10 10 10 10 10 10 10 10 10 10 10 10 10 10 10 10 10 10 134 125 125 125 125 141 125 142 143 144 145 144 145 144 145 146 143 144 145 144 145 144 145 146 143 144 145 144 145 144 145 146 147 148 125 125 125 125 125 140 
10 10 10 10 10 10 10 10 10 10 10 10 10 10 10 10 10 10 10 10 10 10 10 10 134 125 125 149 125 135 150 151 134 125 125 125 125 125 125 140 134 125 125 125 125 125 125 140 134 125 125 125 125 125 125 140 151 152 148 125 153 154 154 155 
10 10 10 10 10 10 10 10 10 10 10 10 10 10 10 10 10 10 10 10 10 10 10 10 134 141 125 125 125 125 140 151 134 156 157 125 125 158 159 140 134 156 148 153 148 150 160 140 134 156 157 125 125 125 161 140 151 151 152 148 162 163 164 165 
10 10 10 10 10 10 10 10 10 10 10 10 10 10 10 10 10 10 10 10 10 10 10 10 166 167 168 168 168 168 169 151 170 171 172 168 168 168 168 173 170 171 174 175 174 175 172 173 170 171 172 168 176 168 177 173 151 151 151 166 178 178 160 179 
4 4 4 4 4 4 4 4 4 4 4 4 4 4 4 4 4 4 4 4 4 4 4 4 4 4 4 4 4 4 4 4 4 4 4 4 4 4 4 4 4 4 4 4 4 4 180 181 182 0 1 2 0 0 1 2 0 0 1 2 0 0 183 184 
4 4 4 4 4 4 4 4 4 185 186 4 4 4 4 4 4 185 186 4 4 187 188 4 4 4 4 187 188 4 4 4 4 185 186 4 4 4 4 4 185 186 4 4 4 4 180 181 10 10 189 190 10 10 189 190 10 10 189 190 10 10 191 184 
4 185 188 4 4 4 4 187 192 193 194 195 187 196 186 187 192 197 194 198 199 200 201 202 4 4 203 204 201 205 4 187 192 197 194 195 185 186 187 192 197 194 198 4 4 206 207 208 209 210 189 190 209 210 189 190 209 210 189 190 209 210 191 184 
192 193 193 211 194 198 4 212 213 214 215 216 204 193 217 218 219 220 221 222 4 223 224 225 4 226 227 228 229 230 231 212 213 220 215 216 193 217 218 219 220 221 222 4 4 232 233 234 48 49 189 190 48 49 189 190 48 49 189 190 235 236 237 191 
238 239 240 239 241 242 243 244 245 246 240 239 240 239 240 239 240 247 243 244 243 244 243 244 243 244 243 244 243 244 243 244 243 248 240 239 240 239 240 239 249 244 245 250 251 252 253 254 255 256 257 258 259 260 257 258 261 260 257 258 262 263 264 265 
266 267 268 267 268 267 268 269 270 271 266 267 268 267 268 267 268 267 268 267 268 267 268 267 268 267 268 267 268 267 268 267 268 267 268 267 268 267 268 267 268 269 272 273 266 267 268 267 268 267 268 267 268 267 268 267 268 267 268 267 268 267 268 267 
