59 220 215 212 213 214 215 212 213 214 215 212 213 214 221 3 166 59 59 59 59 220 215 212 213 214 215 212 213 214 215 212 213 214 215 212 213 214 215 212 213 214 215 212 213 214 215 212 213 214 215 212 213 214 215 212 213 214 215 212 213 214 215 212 213 214 215 212 213 214 215 212 213 214 215 212 213 214 215 212 213 214 221 3 166 167 59 59 59 220 215 212 213 214 215 212 213 214 215 212 213 214 215 212 213 214 215 212 213 214 215 212 213 214 215 212 213 214 215 212 213 214 215 212 213 214 215 212
211 212 213 214 215 212 213 214 215 212 213 214 215 212 213 216 217 218 59 219 211 212 213 214 215 212 213 214 215 212 213 214 215 212 213 214 215 212 213 214 215 212 213 214 215 212 213 214 215 212 213 214 215 212 213 214 215 212 213 214 215 212 213 214 215 212 213 214 215 212 213 214 215 212 213 214 215 212 213 214 215 212 213 216 217 3 166 219 211 212 213 214 215 212 213 214 215 212 213 214 215 212 213 214 215 212 213 214 215 212 213 214 215 212 213 214 215 212 213 214 215 212 213 214 215 212 213 214
204 205 206 207 204 205 208 205 209 210 204 205 206 205 206 207 208 205 209 210 204 205 206 207 204 205 206 207 204 205 206 207 204 205 206 207 204 205 206 207 204 205 206 207 204 205 206 207 204 205 206 207 204 205 206 207 204 205 206 207 204 205 206 207 204 205 206 207 204 205 206 207 204 205 206 207 204 205 206 207 204 205 206 207 208 205 209 210 204 205 206 207 204 205 206 207 204 205 206 207 204 205 206 207 204 205 206 207 204 205 206 207 204 205 206 207 204 205 206 207 204 205 206 207 204 205 206 207
3 3 3 193 194 195 195 195 195 196 197 3 3 3 3 3 3 3 166 167 59 59 59 59 59 59 59 59 59 59 59 59 59 59 168 3 3 3 3 3 3 3 3 3 3 3 3 3 3 3 3 3 3 3 3 3 3 3 3 3 3 3 3 3 3 3 166 167 59 59 59 59 59 59 59 59 59 59 59 59 168 3 3 3 3 3 3 3 166 167 59 183 198 199 168 12 12 3 3 12 12 10 11 12 12 166 167 12 12 10 11 12 12 167 167 12 12 10 11 12 12 59 59 12 12 12 12 33
3 3 180 181 59 179 175 176 176 176 176 182 3 3 3 193 201 194 195 195 189 202 202 59 59 59 59 59 59 59 59 59 202 203 195 195 196 201 197 3 3 3 3 3 3 3 3 3 3 3 3 3 193 194 195 195 195 195 196 197 3 3 3 193 201 194 195 195 189 202 202 59 59 59 59 59 59 59 202 203 195 195 196 201 197 3 3 3 3 3 166 183 198 199 3 12 12 3 3 12 12 10 11 12 12 3 3 12 12 10 11 12 12 3 3 12 12 10 11 12 12 167 167 12 12 12 12 33
3 3 3 166 59 59 59 179 175 176 178 3 3 3 180 187 181 59 175 188 176 176 176 189 167 59 59 59 59 167 190 191 192 59 175 176 176 176 176 182 3 3 193 194 195 196 197 3 3 3 3 180 181 59 179 175 176 176 176 176 182 3 180 187 181 59 175 176 176 176 176 189 59 59 59 167 190 191 192 59 175 176 176 176 176 182 3 3 3 3 3 183 198 199 200 12 12 3 3 12 12 10 11 12 12 3 3 12 12 10 11 12 12 3 3 12 12 10 11 12 12 3 3 12 12 33 12 33
3 3 3 3 166 167 59 59 59 169 3 3 3 3 3 166 59 59 59 59 175 176 177 178 3 166 167 167 168 3 3 166 59 59 59 179 175 176 178 3 3 180 181 59 179 175 176 182 3 3 3 3 166 59 59 59 179 175 176 178 3 3 3 166 59 59 59 179 175 176 177 178 166 167 168 3 3 166 59 59 59 179 175 176 178 3 3 3 3 3 3 183 184 185 186 12 12 28 29 12 12 10 11 12 12 28 29 12 12 10 11 12 12 28 29 12 12 10 11 12 12 28 29 12 12 33 162 33
3 3 3 3 3 3 166 167 168 3 3 3 3 3 3 3 166 167 59 59 59 169 3 3 3 3 3 3 3 3 3 3 166 167 59 59 59 169 3 3 3 3 166 59 59 59 169 3 3 3 3 3 3 166 167 59 59 59 169 3 3 3 3 3 166 167 59 59 59 169 3 3 3 3 3 3 3 3 166 167 59 59 59 169 3 3 3 3 3 3 3 170 171 172 173 174 12 12 12 12 12 10 11 12 12 12 12 12 12 10 11 12 12 12 12 12 12 10 11 12 12 12 12 12 12 33 162 33
3 3 3 3 3 3 3 3 3 3 3 3 3 3 3 3 3 3 166 167 168 3 3 3 3 3 3 3 3 3 3 3 3 3 166 167 168 3 3 3 3 3 3 166 167 168 3 3 3 3 3 3 3 3 3 166 167 168 3 3 3 3 3 3 3 3 166 167 168 3 3 3 3 3 3 3 3 3 3 3 166 167 168 3 3 3 3 3 3 3 3 3 3 164 165 165 12 12 12 12 12 10 11 12 12 12 12 12 12 10 11 12 12 12 12 12 12 10 11 12 12 12 12 12 12 33 162 33
3 3 3 3 3 3 3 3 3 3 3 3 3 3 3 3 3 3 3 3 3 3 3 3 3 3 3 3 3 3 3 3 3 3 3 3 3 3 3 3 3 3 3 3 3 3 3 3 3 3 3 3 3 3 3 3 3 3 3 3 3 3 3 3 3 3 3 3 3 3 3 3 3 3 3 3 3 3 3 3 3 3 3 3 3 3 3 3 3 3 3 3 3 164 165 165 12 12 12 12 12 10 11 12 12 12 12 12 12 10 11 12 12 12 12 12 12 10 11 12 12 12 12 12 12 33 162 33
3 3 3 3 3 3 3 3 3 3 3 3 3 3 3 3 3 3 3 3 3 3 3 3 3 3 3 3 3 3 3 3 3 3 3 3 3 3 3 3 3 3 3 3 3 3 3 3 3 3 3 3 3 3 3 3 3 3 3 3 3 3 3 3 3 3 3 3 3 3 3 3 3 3 3 3 3 3 3 3 3 3 3 3 3 3 3 3 3 3 3 3 3 164 165 165 7 4 4 4 4 5 6 7 4 4 4 4 4 5 6 7 4 4 4 4 4 5 6 7 4 4 4 4 4 33 162 33
3 3 3 3 3 3 3 3 3 3 3 3 3 3 3 3 3 3 3 3 3 3 3 3 3 3 3 3 3 3 3 3 3 3 3 3 3 3 3 3 3 3 3 3 3 3 3 3 3 3 3 3 3 3 3 3 3 3 3 3 3 3 3 3 3 3 3 3 3 3 3 3 3 3 3 3 3 3 3 3 3 3 3 3 3 3 3 3 3 3 3 3 3 164 165 165 1 1 1 1 1 1 1 1 1 1 1 1 1 1 1 1 1 1 1 1 1 1 1 1 1 1 1 1 1 33 162 33
12 12 12 12 12 12 12 12 12 12 12 12 12 12 12 12 12 12 12 12 12 12 12 12 12 12 12 12 12 12 12 12 12 12 12 12 12 12 12 12 12 12 12 12 12 12 12 12 116 123 124 163 163 163 163 163 163 163 163 163 163 125 116 123 124 163 163 163 163 163 163 163 163 163 163 163 163 163 163 125 124 163 163 163 163 163 163 163 163 163 163 163 163 163 163 125 124 163 163 163 163 163 163 163 163 163 163 163 163 163 163 125 116 123 116 123 116 123 116 123 116 123 116 123 116 158 162 125
12 12 12 12 12 12 12 12 12 12 12 12 12 12 12 12 12 12 12 12 12 12 12 12 12 12 12 12 12 12 12 12 12 12 12 12 12 12 12 12 12 12 12 12 12 12 12 12 116 157 150 121 120 121 120 121 120 121 120 121 129 125 116 123 124 121 161 123 116 158 120 121 120 121 120 121 120 121 120 125 124 121 161 123 124 121 120 125 124 121 120 125 116 158 120 125 124 121 161 123 116 158 120 121 156 155 120 121 161 158 120 125 116 123 116 123 116 123 116 157 154 157 154 157 154 155 162 125
12 12 12 12 12 12 12 12 12 12 12 12 12 12 12 12 12 12 12 12 12 12 12 12 12 12 12 12 12 12 12 12 12 12 12 12 12 12 12 12 12 12 12 12 12 12 12 12 124 121 120 130 129 130 129 130 129 130 129 130 129 125 116 123 124 130 156 157 154 155 129 130 129 130 120 121 120 130 129 125 124 130 156 157 150 130 129 149 150 130 129 125 116 158 129 125 124 130 156 157 154 155 129 130 129 130 129 130 156 155 129 125 116 123 116 123 116 123 150 130 129 12 12 12 159 159 160 125
12 12 12 12 12 12 12 12 12 12 12 12 12 12 12 12 12 12 12 12 12 12 12 12 12 12 12 12 12 12 12 12 12 12 12 12 12 12 12 12 12 12 12 12 12 12 12 12 124 121 120 121 120 121 120 121 120 121 120 121 120 125 116 123 124 121 120 121 120 121 120 121 120 121 120 121 120 121 120 125 124 121 120 121 120 121 120 121 120 121 120 149 154 155 120 125 124 121 120 121 120 121 120 121 120 121 120 121 120 121 120 125 116 123 116 123 116 155 120 121 120 136 118 117 118 117 118 123
12 12 12 12 12 12 12 12 12 12 12 12 12 12 12 12 12 12 12 12 12 12 12 12 12 12 12 12 12 12 12 12 12 12 12 12 12 12 12 12 12 12 12 12 12 12 12 12 124 130 129 130 129 130 129 127 129 130 128 130 129 125 116 123 124 130 129 130 129 130 129 130 129 130 129 130 129 130 129 125 124 130 129 130 129 130 129 130 129 130 129 130 129 130 129 125 124 130 129 130 129 130 129 130 129 130 129 130 129 130 129 125 116 123 116 123 150 130 129 130 129 149 154 157 154 157 154 123
12 12 12 12 12 12 12 12 12 12 12 12 12 12 12 12 12 12 12 12 12 12 12 12 12 12 12 12 12 12 12 12 12 12 12 12 12 12 12 12 12 12 12 12 12 12 12 12 124 121 120 121 120 121 120 137 120 121 137 121 120 149 116 123 124 121 120 121 120 121 120 121 120 121 120 121 120 121 120 125 124 121 120 121 120 121 120 121 120 121 120 121 120 121 120 125 124 121 120 121 120 121 120 121 120 121 120 121 120 121 120 125 116 123 116 155 120 121 120 121 120 121 120 121 120 121 120 125
12 12 12 12 12 12 12 12 12 12 12 12 12 12 12 12 12 12 12 12 12 12 12 12 12 12 12 12 12 12 12 12 12 12 12 12 12 12 12 12 12 12 12 12 12 12 12 12 124 130 129 130 129 130 129 121 129 130 121 130 129 130 156 123 124 127 128 127 128 127 128 127 128 127 128 127 128 127 128 125 124 127 128 127 128 127 128 127 128 127 128 127 128 127 128 125 124 127 128 127 128 127 128 127 128 127 128 127 128 127 128 125 116 123 150 130 129 130 129 130 129 130 129 130 129 130 129 125
12 12 12 12 12 12 12 12 12 12 12 12 12 12 12 12 12 12 12 12 12 12 12 12 12 12 12 12 12 12 12 12 12 12 12 12 12 12 12 12 12 12 12 12 12 12 12 12 124 121 120 121 120 121 120 121 120 121 120 121 120 121 12 149 150 151 152 153 153 151 152 153 153 151 152 153 153 151 152 149 150 151 152 153 153 151 152 153 153 151 152 153 153 151 152 149 150 151 152 153 153 151 152 153 153 151 152 153 153 151 152 149 154 155 120 121 120 121 120 121 120 121 120 121 120 121 120 125
12 12 12 12 12 12 12 12 12 12 12 12 12 12 12 12 12 12 12 12 12 12 12 12 12 12 12 12 12 12 12 12 12 12 12 12 12 12 12 12 12 12 12 12 12 12 12 12 124 130 129 130 129 130 129 130 129 130 129 130 128 130 12 12 144 145 146 147 148 145 146 147 148 145 146 147 148 145 146 147 148 145 146 147 148 145 146 147 148 145 146 147 148 145 146 147 148 145 146 147 148 145 146 147 148 145 146 147 148 145 146 144 12 12 129 130 129 130 129 130 129 130 129 130 129 130 129 125
12 12 12 12 12 12 12 12 12 12 12 12 12 12 12 12 12 12 12 12 12 12 12 12 12 12 12 12 12 12 12 12 12 12 12 12 12 12 12 12 12 12 12 12 12 12 12 12 124 121 120 121 120 121 120 121 120 121 120 121 137 121 12 12 138 139 140 141 142 139 140 141 142 139 140 141 142 139 140 141 142 139 140 141 142 139 140 141 142 139 140 141 142 139 140 141 142 139 140 141 142 139 140 141 142 139 140 141 142 139 140 143 12 12 120 121 120 121 120 121 120 121 120 121 120 121 120 125
12 12 12 12 12 12 12 12 12 12 12 12 12 12 12 12 12 12 12 12 12 12 12 12 12 12 12 12 12 12 12 12 12 12 12 12 12 12 12 12 12 12 12 12 12 12 12 12 124 127 128 127 128 127 128 127 128 127 128 127 129 130 12 117 131 132 133 134 135 132 133 134 135 132 133 134 135 132 133 136 131 132 133 134 135 132 133 134 135 132 133 134 135 132 133 136 131 132 133 134 135 132 133 134 135 132 133 134 135 132 133 136 131 12 128 127 128 127 128 127 128 127 128 127 128 127 128 125
12 12 12 12 12 12 12 12 12 12 12 12 12 12 12 12 12 12 12 12 12 12 12 12 12 12 12 12 12 12 12 12 12 12 12 12 12 12 12 12 12 12 12 12 12 12 12 12 116 117 118 117 118 117 118 117 118 117 118 119 120 121 122 123 124 121 120 121 120 121 120 121 120 121 120 121 120 121 120 125 124 121 120 121 120 121 120 121 120 121 120 121 120 121 120 125 124 121 120 121 120 121 120 121 120 121 120 121 120 121 120 125 116 117 118 117 118 117 118 117 118 126 118 117 118 117 118 123
111 111 111 111 111 111 111 111 111 111 111 111 111 111 111 111 111 111 111 111 111 114 82 82 115 111 111 111 111 111 111 111 111 111 111 111 111 111 111 111 111 111 111 111 111 111 111 111 111 111 111 111 111 111 111 111 111 111 111 114 3 3 31 32 12 12 12 12 12 12 12 12 12 12 12 12 12 12 12 12 12 12 12 12 12 12 12 12 12 12 12 12 12 12 12 12 12 12 12 12 12 12 12 12 12 12 12 12 12 12 12 12 12 12 12 12 12 12 12 12 12 12 12 12 12 12 12 12
111 111 111 111 111 111 111 111 111 111 111 111 111 111 111 111 111 111 111 112 108 109 3 3 110 108 113 111 111 111 111 111 111 111 111 111 111 111 111 111 111 111 111 111 111 111 111 111 111 111 111 111 111 111 111 111 111 112 108 109 3 3 3 33 12 12 12 12 12 12 12 12 12 12 12 12 12 12 12 12 12 12 12 12 12 12 12 12 12 12 12 12 12 12 12 12 12 12 12 12 12 12 12 12 12 12 12 12 12 12 12 12 12 12 12 12 12 12 12 12 12 12 12 12 12 12 12 12
108 108 108 108 108 108 108 108 108 108 108 108 108 108 108 108 108 108 108 109 3 3 3 3 3 3 110 108 108 108 108 108 108 108 108 108 108 108 108 108 108 108 108 108 108 108 108 108 108 108 108 108 108 108 108 108 108 109 3 3 3 3 3 33 12 12 12 12 12 12 12 12 12 12 12 12 12 12 12 12 12 12 12 12 12 12 12 12 12 12 12 12 12 12 12 12 12 12 12 12 12 12 12 12 12 12 12 12 12 12 12 12 12 12 12 12 12 12 12 12 12 12 12 12 12 12 12 12
94 102 98 102 98 3 3 3 3 10 103 104 105 3 3 10 11 3 3 3 3 3 3 3 3 3 3 3 3 102 103 60 104 105 3 3 3 3 3 102 98 3 3 3 106 107 3 103 60 102 98 61 104 105 3 3 3 3 3 3 3 3 3 33 12 12 12 12 12 12 12 12 12 12 12 12 12 12 12 12 12 12 12 12 12 12 12 12 12 12 12 12 12 12 12 12 12 12 12 12 12 12 12 12 12 12 12 12 12 12 12 12 12 12 12 12 12 12 12 12 12 12 12 12 12 12 12 12
98 92 99 100 101 3 3 3 3 10 11 3 3 3 3 10 11 3 3 3 3 3 3 3 3 3 3 3 3 92 94 3 3 3 3 3 3 3 3 92 91 3 3 3 3 3 3 3 3 96 99 3 3 3 3 3 3 3 3 3 3 3 3 33 12 12 12 12 12 12 12 12 12 12 12 12 12 12 12 12 12 12 12 12 12 12 12 12 12 12 12 12 12 12 12 12 12 12 12 12 12 12 12 12 12 12 12 12 12 12 12 12 12 12 12 12 12 12 12 12 12 12 12 12 12 12 12 12
94 92 94 33 97 3 3 3 3 10 11 3 3 3 3 10 11 3 3 3 3 3 3 3 3 3 3 3 3 92 91 3 3 3 3 3 3 3 3 92 94 3 3 3 3 3 3 3 3 92 94 3 3 3 3 3 3 3 3 3 3 3 3 33 12 12 12 12 12 12 12 12 12 12 12 12 12 12 12 12 12 12 12 12 12 12 12 12 12 12 12 12 12 12 12 12 12 12 12 12 12 12 12 12 12 12 12 12 12 12 12 12 12 12 12 12 12 12 12 12 12 12 12 12 12 12 12 12
94 92 91 90 89 3 3 3 3 10 11 3 3 3 3 10 11 3 3 3 3 3 3 3 3 3 3 3 3 96 94 3 3 3 3 3 3 3 3 96 94 3 3 3 3 3 3 3 3 92 94 3 3 3 3 3 3 3 3 3 3 3 3 33 12 12 12 12 12 12 12 12 12 12 12 12 12 12 12 12 12 12 12 12 12 12 12 12 12 12 12 12 12 12 12 12 12 12 12 12 12 12 12 12 12 12 12 12 12 12 12 12 12 12 12 12 12 12 12 12 12 12 12 12 12 12 12 12
94 92 95 3 3 3 3 3 3 10 11 3 3 3 3 10 11 3 3 3 3 3 3 3 3 3 3 3 3 93 94 3 3 3 3 3 3 3 3 90 89 3 3 3 3 3 3 3 3 92 91 3 3 3 3 3 3 3 3 3 3 3 3 33 12 12 12 12 12 12 12 12 12 12 12 12 12 12 12 12 12 12 12 12 12 12 12 12 12 12 12 12 12 12 12 12 12 12 12 12 12 12 12 12 12 12 12 12 12 12 12 12 12 12 12 12 12 12 12 12 12 12 12 12 12 12 12 12
91 92 33 3 3 3 3 3 3 10 11 3 3 3 3 10 11 3 3 3 3 3 3 3 3 3 3 3 3 90 89 3 3 3 3 3 3 3 3 3 3 3 3 3 3 3 3 3 3 93 94 3 3 3 3 3 3 3 3 3 3 3 3 33 12 12 12 12 12 12 12 12 12 12 12 12 12 12 12 12 12 12 12 12 12 12 12 12 12 12 12 12 12 12 12 12 12 12 12 12 12 12 12 12 12 12 12 12 12 12 12 12 12 12 12 12 12 12 12 12 12 12 12 12 12 12 12 12
89 90 89 3 3 3 3 3 3 10 11 3 3 3 3 10 11 3 3 3 3 3 3 3 3 3 3 3 3 3 3 3 3 3 3 3 3 3 3 3 3 3 3 3 3 3 3 3 3 90 89 3 3 3 3 3 3 3 3 3 3 3 3 33 12 12 12 12 12 12 12 12 12 12 12 12 12 12 12 12 12 12 12 12 12 12 12 12 12 12 12 12 12 12 12 12 12 12 12 12 12 12 12 12 12 12 12 12 12 12 12 12 12 12 12 12 12 12 12 12 12 12 12 12 12 12 12 12
3 3 3 3 3 9 4 4 4 5 6 7 4 4 4 5 6 7 4 4 8 3 3 3 3 3 3 3 3 3 3 3 3 3 3 3 3 3 3 3 3 3 3 3 3 3 3 3 3 3 3 3 3 3 3 3 3 3 3 3 3 3 3 33 12 12 12 12 12 12 12 12 12 12 12 12 12 12 12 12 12 12 12 12 12 12 12 12 12 12 12 12 12 12 12 12 12 12 12 12 12 12 12 12 12 12 12 12 12 12 12 12 12 12 12 12 12 12 12 12 12 12 12 12 12 12 12 12
3 3 3 3 1 1 1 1 1 1 1 1 1 1 1 1 1 1 1 1 1 2 3 3 3 3 3 3 3 3 3 3 3 3 3 3 3 3 3 3 3 3 3 3 3 3 3 3 3 3 3 3 3 3 3 3 3 3 3 3 3 3 3 33 12 12 12 12 12 12 12 12 12 12 12 12 12 12 12 12 12 12 12 12 12 12 12 12 12 12 12 12 12 12 12 12 12 12 12 12 12 12 12 12 12 12 12 12 12 12 12 12 12 12 12 12 12 12 12 12 12 12 12 12 12 12 12 12
31 32 31 32 33 42 43 44 42 43 43 44 42 43 43 44 42 43 43 44 42 43 43 44 42 43 43 51 57 76 77 3 78 79 77 3 78 79 77 3 78 79 77 3 78 79 77 3 78 79 77 3 78 80 57 57 58 81 82 82 82 83 84 82 82 82 83 84 82 82 82 83 85 85 85 86 87 84 82 82 88 43 44 42 43 51 65 66 67 68 70 57 58 44 42 43 43 44 42 43 43 44 42 43 43 44 42 43 43 44 42 43 43 44 42 43 43 44 42 43 43 44 42 43 43 44 42 43
3 3 3 3 31 32 31 32 31 32 31 32 31 32 31 32 31 32 31 32 31 32 31 32 31 32 33 42 51 65 66 67 68 69 66 67 68 69 66 67 68 69 66 67 68 69 66 67 68 69 66 67 68 70 57 58 31 32 3 3 3 71 72 3 3 3 71 72 3 3 3 71 73 73 73 73 73 72 3 3 31 32 31 32 33 42 51 52 74 75 57 58 31 32 31 32 31 32 31 32 31 32 31 32 31 32 31 32 31 32 31 32 31 32 31 32 31 32 31 32 31 32 31 32 31 32 31 32
3 3 3 3 3 3 3 3 3 10 11 3 3 3 3 10 11 3 3 3 3 3 3 3 3 3 3 33 42 51 52 53 54 55 56 53 54 55 56 53 54 55 56 53 54 55 56 53 54 55 56 53 54 57 58 33 3 3 3 3 3 3 3 3 3 3 3 3 3 3 3 3 59 60 60 60 61 3 3 3 3 3 41 62 63 33 42 43 44 42 43 33 3 3 3 3 10 11 12 12 12 3 3 12 12 12 12 3 3 12 12 12 12 3 3 20 15 20 64 3 3 16 17 16 17 16 17 16
3 3 3 3 3 3 3 3 3 10 11 3 3 3 3 10 11 3 3 3 3 3 3 3 3 3 3 3 33 42 43 43 43 44 42 43 43 44 42 43 43 44 42 43 43 44 42 43 43 44 42 43 43 43 33 3 3 3 3 3 3 3 3 3 3 3 3 3 3 3 3 3 3 45 46 47 48 3 3 3 3 3 27 25 38 49 33 31 32 31 32 3 3 3 3 3 10 11 12 12 12 3 3 12 12 12 12 3 3 12 12 12 19 3 3 18 16 17 50 3 3 17 16 17 16 17 16 17
3 3 3 3 3 3 3 3 3 10 11 3 3 3 3 10 11 3 3 3 3 3 3 3 3 3 3 3 3 31 32 31 32 31 32 31 32 31 32 31 32 31 32 31 32 31 32 31 32 31 32 31 32 33 3 3 3 3 3 3 3 3 3 3 3 3 3 3 3 3 3 3 3 34 35 36 37 3 3 3 3 3 3 3 24 38 39 40 41 3 3 3 3 3 3 3 10 11 12 12 12 3 3 12 12 12 12 3 3 12 12 12 15 3 3 20 15 16 17 3 3 16 17 16 17 16 17 16
3 3 3 3 3 3 3 3 3 10 11 3 3 3 3 10 11 3 3 3 3 3 3 3 3 3 3 3 3 3 3 3 3 3 3 3 3 3 3 3 3 3 3 3 3 3 3 3 3 3 3 3 3 3 3 3 3 3 3 3 3 3 3 3 3 3 3 3 3 3 3 3 3 3 21 22 23 3 3 3 3 3 3 3 3 24 25 26 27 3 3 3 3 3 3 3 10 11 12 12 12 28 29 12 12 12 12 28 29 12 12 12 12 28 29 18 16 17 30 28 29 17 16 17 16 17 16 17
3 3 3 3 3 3 3 3 3 10 11 3 3 3 3 10 11 3 3 3 3 3 3 3 3 3 3 3 3 3 3 3 3 3 3 3 3 3 3 3 3 3 3 3 3 3 3 3 3 3 3 3 3 3 3 3 3 3 3 3 3 3 3 3 3 3 3 3 3 3 3 3 3 3 3 3 3 3 3 3 3 3 3 3 3 3 3 3 3 3 3 3 3 3 3 3 10 11 12 12 12 12 12 12 12 12 12 12 12 12 12 12 15 20 15 16 17 16 17 16 17 16 17 16 17 16 17 16
3 3 3 3 3 3 3 3 3 10 11 3 3 3 3 10 11 3 3 3 3 3 3 3 3 3 3 3 3 3 3 3 3 3 3 3 3 3 3 3 3 3 3 3 3 3 3 3 3 3 3 3 3 3 3 3 3 3 3 3 3 3 3 3 3 3 3 3 3 3 3 3 3 3 3 3 3 3 3 3 3 3 3 3 3 3 3 3 3 3 3 3 3 3 3 3 10 11 12 12 12 12 12 12 12 12 12 12 12 12 12 12 12 18 19 18 19 18 16 17 16 17 16 17 16 17 16 17
3 3 3 3 3 3 3 3 3 10 11 3 3 3 3 10 11 3 3 3 3 3 3 3 3 3 3 3 3 3 3 3 3 3 3 3 3 3 3 3 3 3 3 3 3 3 3 3 3 3 3 3 3 3 3 3 3 3 3 3 3 3 3 3 3 3 3 3 3 3 3 3 3 3 3 3 3 3 3 3 3 3 3 3 3 3 3 3 3 3 3 3 3 3 3 3 10 11 12 12 12 12 12 12 12 12 12 12 12 12 12 12 15 16 17 16 17 16 17 16 17 16 17 16 17 16 17 16
3 3 3 3 3 3 3 3 3 10 11 3 3 3 3 10 11 3 3 3 3 3 3 3 3 3 3 3 3 3 3 3 3 3 3 3 3 3 3 3 3 3 3 3 3 3 3 3 3 3 3 3 3 3 3 3 3 3 3 3 3 3 3 3 3 3 3 3 3 3 3 3 3 3 3 3 3 3 3 3 3 3 3 3 3 3 3 3 3 3 3 3 3 3 3 3 10 11 12 12 12 12 12 12 12 12 12 12 12 12 12 12 13 14 13 14 13 14 13 14 13 14 13 14 13 14 13 14
4 4 4 4 4 4 4 4 4 5 6 7 4 4 4 5 6 7 4 4 4 4 8 3 3 3 3 3 3 3 3 3 3 3 3 3 3 3 3 3 3 3 3 3 3 3 3 3 3 3 3 3 3 3 3 3 3 3 3 3 3 3 3 3 3 3 3 3 3 3 3 3 3 3 3 3 3 3 3 3 3 3 3 3 3 3 3 3 3 3 3 3 3 3 3 9 5 6 4 4 4 4 4 4 4 4 4 4 4 4 4 4 4 4 4 4 4 4 4 4 4 4 4 4 4 4 4 4
1 1 1 1 1 1 1 1 1 1 1 1 1 1 1 1 1 1 1 1 1 1 1 2 3 3 3 3 3 3 3 3 3 3 3 3 3 3 3 3 3 3 3 3 3 3 3 3 3 3 3 3 3 3 3 3 3 3 3 3 3 3 3 3 3 3 3 3 3 3 3 3 3 3 3 3 3 3 3 3 3 3 3 3 3 3 3 3 3 3 3 3 3 3 1 1 1 1 1 1 1 1 1 1 1 1 1 1 1 1 1 1 1 1 1 1 1 1 1 1 1 1 1 1 1 1 1 1