1 2 2 2 2 2 2 3 4 5 5 5 5 5 5 5 5 5 5 5 5 5 5 5 6 7 5 6 7 5 5 8
4 5 5 5 5 5 5 8 4 5 5 5 5 5 5 5 5 5 5 5 5 5 5 5 6 7 5 6 7 5 5 9
4 5 5 5 5 5 5 8 4 5 5 5 5 5 5 5 5 5 5 5 5 10 11 5 12 13 14 12 15 5 16 17
4 5 5 5 5 5 5 18 19 5 5 5 5 5 5 5 5 5 5 5 5 20 21 14 6 22 23 6 24 14 25 26
4 27 28 29 5 5 5 5 5 5 30 5 30 5 31 32 5 31 32 5 5 6 22 23 6 22 23 6 22 33 34 35
36 37 38 36 39 28 28 28 40 41 42 41 43 41 44 45 41 44 45 41 46 28 28 28 28 28 28 28 28 28 40 47 