96 77 77 77 77 77 91 97	77 98 20 99 100	101 102 103 20 104 77 103 20 104 105 106 107 103 20 20 97 77 78 108
71 72 63 73 72 63 74 75	30 76 77 78 30 31 79 80	81 82 83 84 81 85 86 87	88 89 90 91 92 93 94 95
48 49 50 51 49 45 52 30	31 30 53 30 31	33 54 55 56 57 58 56 59	60 61 62 63 64 65 66 67 68 69 70
29 6 6 6 6 6 6 31 33 34 6 35 36 31 6 6 6 6 37 38 39 40 41 42 43	43 44 45 46 30 31 47
29 6 6 6 6 6 6 30 31 30	6 30 31 30 6 6 6 6 6 6 6 6 6 6 6 6 6 6 6 6 6 32
29 6 6 6 6 6 6 6 6 6 6 6 6 6 6 6 6 6 6 6 6 6 6 6 6 6 6 6 6 6 6 7
27 28 28 28 28 5 6 6 6 6 6 6 6 6 6 6 6 6 6 6 6 6 6 6 6	6 6 6 6 25 26 7	
18 19 20 21 22 23 6 6 6 6 6 6 6 6 6 6 6 6 6 24 6 25 26 6 24 6 24 6 24 6 6 7
8 14 15	16 11 6	6 6 6 6	6 6 6 6	6 6 6 17 6 6 6 6 6 6 6 6 6 6 6 6 6 7
12 10 9	10 13 6	6 6 6 6	6 6 6 6 6 6 6 6 6 6 6 6	6 6 6 6	6 6 6 6	6 7
8 9 10 9 11 6 6 6 6 6 6 6 6 6 6 6 6 6 6 6 6 6 6 6 6 6 6 6 6 6 6 7
1 2 3 2 4 5 6 6 6 6 6 6 6 6 6 6 6 6 6 6 6 6 6 6 6 6 6 6 6 6 6 7
